NO assets/textures/eagle.xpm
SO assets/textures/wood.xpm
WE assets/textures/redbrick.xpm
EA assets/textures/tree.xpm
F 109,109,109
C 23,236,255


111111111     111111111                    111111 1111111                  
100000001     100000001                    1000001 1000001                 
 100000001     100000001                    1000001 1000001
 111000001     100000011                    1000001 1000001                  
    1000001     1000001      111111111111    1100001 1100001    11111111111   
    1000001     1000001    1100000000000011   100001  100001  110000000000011 
    1000000111110000001   10000001111100000111100001  100001 10000000000000001
    1000000000000000001  10000001     1000W000000001  100001 10000011111000001
    1000000000000000001  100000001111100000011100001  100001 100001     100001
    1000000111110000001  1000000000000000001  100001  100001 100001     100001
    1000001     1000001  100000011111111111   100001  100001 100001     100001
    1000001     1000001111100000001           100001  100001 100001     100001
  110000001     1000000000000000001          100000011000000110000011111000001
  100000001     100000001110000000011111111  100000000000000000000000000000001
  100000001     100000001  1100000000000001  10000001100000011110000000000011 
  111011111     111111111    11111111111111  1111111111111111   11111111111   
    101
    1011111      1111111    111111111111111111 
   10000001     10000001    100000000000000001 
  100000001    100000001    100000000000000001 
  111000001    111000001    100000111111111111 
     100001       100001    1000001            
     100001       100001    1000001            
     100001       100001    1000001111111111   
     100001       100001    10000000000000001  
     100001       100001    111111111111000001 
     100001       100001                1000001
     100001       100001                1000001
     100001       100001   11111111     1000001
  111000000111 11100000011100000000111110000001
  10000000000010000000000000111000000000000011 
  10000000000000000000000011   1100000000011   
  1111111111111111111111111      111111111
