NO assets/textures/tree.xpm
SO assets/textures/tree.xpm
WE assets/textures/tree.xpm
EA assets/textures/tree.xpm
F 184,113,39
C 51,198,007

        1111111111111111111111111
        1000000000110000000000001
        1011000001110000000000001
        1001000000000000000000001
111111111011000001110000000000001
100000000011000001111111111111111
11110111111111011100000010001
11110111111111010101010010001
11000000110101011100000010001
10000000000000001100000000001
10000000000000001101010010001
11000001110101011111011110N0111
11110111 1110101 101111010001
11111111 1111111 111111111111
