NO ./assets/north.xpm
SO ./assets/south.xpm
WE ./assets/west.xpm
EA ./assets/east.xpm

F 238,238,238
C 190,70,70

111111111111111111111111
1000S0000000000000000001
100000000000000000000001
100000000000000000000001
111111111111111111111111
